NO ./textures/wall_n.xpm
SO ./textures/wall_s.xpm
WE ./textures/wall_w.xpm
EA ./textures/wall_e.xpm
F 220,100,0
C 100,200,255

111111
1000N1
100001
111111
