NO ./textures/wall.xpm
SO ./textures/wall.xpm
WE ./textures/wall.xpm
EA ./textures/wall.xpm
F 10,5,3
C 60,0,0

111111111111111
100000000000001
100011100000001
10001000010000111111111
10001000010100000000001
10001110010000000000001
1000W000000000111111111
100000000000001
100000000000001
100000000000001
111111111111111
