NO ./textures/wall_n.xpm
SO ./textures/wall_s.xpm
WE ./textures/wal_w.xpm
EA ./textures/wall_e.xpm
F 220,100,0
C 180,180,180

111111
1000N1
100001
111111
