NO ./textures/wallbl.xpm
EA ./textures/wallbl.xpm
WE ./textures/wallbl.xpm
SO ./textures/wallbl.xpm


F 0,50,55
C 60,0,0


 1111111111111
100000000000001
100011100000001
10000111111100011111111   1
10001      1000000000001 101
10001     1001111111111   1
10001111110001
100000000000001
1000001110000E1
 1111111111111
