NO ./textures/wallwt.xpm
SO ./textures/wallbl.xpm
WE ./textures/wallpk.xpm
EA ./textures/wallgr.xpm

F 10,5,3
C 60,0,0

111111111111111
100000000000E01
100011100000001
100011111111000111111111    
10001      100000D000001   
10001      1001111111111    
10001111111001
100000101000001
100000111000001
111111111111111
